XXXXXXXXXXXXXXX
X_____________X
X_____________X
X_____________X
X_____________X
X_____________X
X_____________X
X_____________X
X_____________X
X_____________X
X_____________X
X_____________X
X_____________X
X_____________X
XXXXXXXXXXXXXXX
IIIIIIIIIIIIIII
